9
8
s..www..
ww.www..
.......g
...www..
ww.www..
ww.www..
........
...www..
ww.www..